^!!!>!!!!>!!!!!!!!!&
$...$....$.........$
$.~.$.~..$.`!!!!!&.$
$.$.$.$..$.....s.$.$
$.$.?.$..|!!!!!!!*.$
$c$...$..?....c....$
|!.!!!</...^>>>>>>!,
$.$.....c~.%<<<<<*c$
$.$.^!&..$.........$
$.%!*.%/.$.`!!&.`!!,
$........$....$...@$
%!!!!!!!!<!!!!<!!!!*
