^!!!>!!!!>!!!!!!!!!&
$...$....$.........$
$.~.$.~..$.`!!!!!&.$
$.$.$.$..$.....s.$.$
$.$.?.$..|!!!!!!!*.$
$c$...$.e?....c...e$
|!.!!!</..e^>>>>>>!,
$.$.....c~.%<<<<<*c$
$.$.^!&..$........e$
$.%!*.%/.$.`!!&.`!!,
$.......e$....$...@$
%!!!!!!!!<!!!!<!!!!*
