^!!>!!!>>!!!!>!!!!!&
$..?.c.|*....$c....$
$......$..`&.|!!!&.$
$.^>/.`b/..$.?..s$.$
?.%*...?...$....`*.?
.....~...~.$.^/.....
^!!!!<!!!<!*.$c`!/.~
$........e...$.....$
|!>!!!>!/..^!<!!!!!,
$.?...?....?.......$
$...~...~.........@$
%!!!<!!!<!!!!!!!!!!*
