^!!>!!!>>!!!!>!!!!!&
$..?..c|*...e$c...e$
$......$..`&.|!!!&.$
$.^>/.`b/..$.?..s$.$
?.%*...?...$....`*.?
.....~...~.$.^/...e.
~.`!!<!!!<!*.$c`!/.~
$............$....e$
|!>!!!>!/..^!<!!!!!,
$.?...?....?.......$
$...~...~.........@$
%!!!<!!!<!!!!!!!!!!*
